################
#.........*....#
#..............#
#..............#
#.......#......#
#.......########
#..............#
#..............#
#.......@......#
#..............#
#..............#
################
