################
#R........*....#
#..............#
#.......########
#..............#
#..............#
#..............#
#..............#
#.......@......#
#..............#
#..............#
################
