################
#.........*....#
#..............#
#.......########
#..............#
#..#...........#
####...........#
#..............#
#.......@......#
#..............#
#..............#
################
